Analysis	Mathematical analysis	Análisis matemático
iterierte	seismic	conocemos
gebiete	disjoint	simular
insofern	gould	crea
erfahrung	réelle	firmes
impliziter	surprising	diseñar
integralsätze	monogenic	cortaduras
entscheidende	edited	adiciones
mitsamt	running	discípulos
page	jiri	actitud
harmonischen	traditionally	desagradable
phonetischen	extremizing	análsis
abstrakteren	edp	costumbre
davis	vast	compondrían
lösungsmethoden	april	preguntarse
unbestimmtes	contributions	aplicadas
schule	arts	fechada
modern	rediscovered	agosto
sagen	isolate	descritos
hauptgegenständen	cells	inventan
distributionentheorie	dynamically	estableció
ingenieurwissenschaften	simon	evitada
eigenständigen	refine	discusión
mittlere	semiring	valieron
anpassung	alongside	continuaron
mikrolokalen	rejecting	desarrolla
kulturen	smoothness	padrinazgo
calculus	annihilated	decidiera
lösungsstruktur	followers	sirvió
teilen	capes	refinar
standpunkt	arithmetization	julio
Differentialrechnung	Differential calculus	Cálculo diferencial
veränderungen	obsolete	apartado
knickfrei	optimization	engeivalores
robinson	systematically	compone
mehrdimensional	historian	augustin
inputfaktoren	edwards	tasa
sekantensteigungen	geometers	despreciable
grundlagenfach	diffuses	tome
effektiv	blaise	incrementará
anstelle	argued	concluyente
wählte	concluded	diferenciada
symptomatisch	rod	instantáneas
erwiesen	aryabhata	estilo
besten	corners	mapeo
winkelhalbierenden	hint	aprendizaje
gewonnen	observation	louis
identitäten	pasted	cambian
male	analysed	aproximando
grundproblem	argue	hostetler
mathematikanwender	shortest	evalúa
unsicherheit	rearranging	single
aktienkursen	vital	criterio
springe	macmillan	examinar
nablavektor	roshdi	tangencia
schwer	sharaf	fuerte
gleichwohl	earned	tender
wissenschaften	contested	linés
arbeiteten	therefrom	eigenvalor
auflage	pascal	críticos
modellierung	perga	acercan
studierende	transport	ron
Differentialrechnung	Derivative	Derivada
veränderungen	imposes	coincidía
knickfrei	sensitivity	infinitésimos
robinson	abbreviations	terminología
mehrdimensional	pullback	mediados
inputfaktoren	thread	llevaría
sekantensteigungen	deficiency	observando
grundlagenfach	begun	miedo
effektiv	room	aporte
anstelle	monotone	elige
wählte	clarify	sola
symptomatisch	adapt	alternativamente
erwiesen	hardly	creadores
besten	chooses	incompleta
winkelhalbierenden	split	hablamos
gewonnen	oral	tramos
identitäten	shortcuts	típicos
male	assembling	aspecto
grundproblem	jet	podrían
mathematikanwender	shadow	progresivamente
unsicherheit	gâteaux	hállese
aktienkursen	concave	bonaventura
springe	unmanageable	temporal
nablavektor	retains	formular
schwer	collects	sociales
gleichwohl	nearby	johannes
wissenschaften	paralleled	forzosamente
arbeiteten	alone	cancelarse
auflage	inspired	monotonía
modellierung	instantaneous	identificar
studierende	incorrectly	relativamente
Integralrechnung	Integral	Integración
integraltafeln	creditor	solapamiento
gründen	progressively	hölder
darstellbarkeit	wedge	gravedad
konvergenzsätze	untenable	etiquetada
fassregel	heuristically	obispo
indikatorfunktion	inaccuracy	participa
begrenzen	arabic	conducto
limites	ralph	concepciones
oberflächen	subintervals	aplicarle
rohr	improper	cerradas
abkürzung	benefits	analizada
konsistent	interpolate	inclinado
langes	solids	pregunta
mangel	flowing	explora
kürzeren	reached	tediosas
breite	extrapolated	altamente
oberfläche	parabolas	ralph
speziellere	coins	hiperparalelepípedo
definiertes	improves	riemman
problematik	subtracts	compactamente
wonach	partitioning	sofisticadas
funktionensklassen	daniell	etiquetas
vertikalen	bracketed	torno
regelfunktion	evenly	asemeje
einheitsquadrat	reprinted	funcion
abgesehen	seem	atención
flächenelemente	puts	partirla
uneigentlicher	kinematics	borde
zuweisung	irregular	sabe
legen	memorably	dualidad
Fundamentalsatz der Analysis	Fundamental theorem of calculus	Teorema fundamental del cálculo
institut	looked	calculus
science	seemingly	investigadas
erstellten	crux	vinculado
integraldefinition	relax	calculadores
development	surrounding	reconoció
variieren	perish	conocimiento
prozess	offered	convergence
augustin	stopwatch	xiv
edwards	gregorie	esencialmente
januar	keep	convirtiéndose
signumfunktion	links	intuitiva
teils	harpercollins	mostrado
funktionenklasse	car	tfc
louis	fourteenth	apariencia
absolut	memorial	sada
einheitshalbkreises	admit	sistematizó
interessanter	recovers	venía
realteil	predate	estudiante
hernandez	speedometer	relevancia
weswegen	excess	theorem
einseitig	student	mejora
induzierter	lopez	hallando
fundamental	fritz	sabían
starke	remember	demostrando
tangentenberechnung	net	llamaríamos
erhielt	relevance	estudiadas
kurvenintegrale	january	histórica
formelle	evidence	seguía
fachhochschule	surfaces	completó
integralfunktion	submanifold	constatación
Grenzwert (Funktion)	Limit of a function	Límite de una función
häufungspunkt	quantifier	aproximándose
definitionsvarianten	projectively	secciones
beidseitiger	informal	utilizaremos
statische	transparent	queramos
erstens	jeff	equilátera
jüngerer	criticism	listadas
genügend	basics	métricas
verboten	asked	añadir
folgendefinition	bŀaszczyk	verificándose
filters	walking	simboliza
umgebungsfilter	nonetheless	salvedad
ausdrücklich	notices	converjan
symbolischen	tennessee	tienden
punktierten	anywhere	inexistencia
vermeidung	oscillatory	formados
eigentliche	landscape	evitando
grenzwertdefinition	short	decrece
entscheidend	keisler	combinarla
klassische	asymptote	darse
misst	judith	crezca
beruhenden	verbal	red
einseitigen	punctured	tremendamente
grenzwertsätze	inappropriate	implícita
empfehlen	claims	inecuación
grenzwertsatz	establish	próximos
ergiebig	congress	expuso
häufungspunktes	deleted	agujereado
umgebungen	writes	luis
missverständnissen	lifetime	respectivas
erzeugte	courant	supóngase
Extremwert	Maxima and minima	Extremos de una función
nachbarschaftsfunktion	extremum	obvio
extremalpunkte	plurals	colectivamente
extremum	extrema	situado
anhand	glowing	optimización
vergleiche	poset	prácticas
extremwerte	propose	jacobiana
nachbarn	plural	evidentes
lokales	seeing	sujeto
quasikonvex	substantial	halle
quasikonkav	sub	multiplicadores
erzielen	reductio	iguala
größtmögliche	greatest	pertenenciente
seitenlängen	maximal	debemos
extremwert	global	buscar
schwächt	maximum	despeja
ableitbar	maxima	localizar
unterhalbstetiges	minimum	posea
konkav	minima	totalidad
innerer	stationary	requeriría
globales	collectively	halla
dritte	totally	minimizando
randpunkten	figure	cumplirse
vorgaben	strict	estricto
quasikonvexe	pierre	locales
strikte	mutual	separado
zugleich	web	relativos
kriterien	pages	básico
umfang	minimal	alcanzar
regentropfens	local	sustituir
extremwerten	look	inflexión
Funktion (Mathematik)	Function (mathematics)	Función matemática
bestehend	declaration	mamíferos
programmierumgebungen	assertion	denotarían
zugeordnete	rendition	duración
transitionsrelation	ethan	transcurrido
terminus	allowable	especificación
fruchtbare	akin	mueve
lineis	uncomputable	determinados
einzeln	outlined	trabaja
zuordnung	kurt	cúbica
exaktifizierungsprozess	wishes	contraste
umkehrbare	recipe	ciudades
surjektiven	categorification	eugenio
stelligkeit	customary	recogerse
ordinatim	fahrenheit	priori
sehnenlängen	epistemology	infiriendo
funktionswertes	quarter	presentar
rechenvorschrift	exploring	mactutor
quellmenge	exclamation	elecciones
tripelschreibweise	stress	correspondía
gnu	permissible	adopte
ansätze	lambda	innumerables
fähigkeiten	jesper	desplace
geschmack	reading	contempla
fourier	cleaner	actuar
schlicht	guershon	círculo
manuskript	virginia	recorrida
circuli	rigor	empareje
bololeschen	conflated	partidos
raumtemperatur	publishing	peter
feststellen	drop	palabras
Mengenlehre	Set theory	Teoría de conjuntos
erkannt	bertrand	bertrand
längere	twentieth	constituyendo
bertrand	constructible	actualidad
logik	polarized	colecciones
steril	behaved	plantear
quine	hyperarithmetical	denominados
erfolgsgeschichte	constructivism	históricamente
zeugt	notable	consideradas
gleichmächtigen	ontology	paradoja
fraenkels	adjoins	razona
gab	pointless	cardinal
bourbaki	deeply	apoyan
frege	contradiction	polémico
endgültige	debate	asuma
nichtmenge	accept	comportan
ieke	views	ernst
negation	joy	fraenkel
extensionalitätsaxiom	claimed	precisas
elementanzahl	devlin	propició
komplement	zermelo	pertenencia
russellsche	readers	contradicción
gödels	schmidt	histórico
christian	embodying	philosophy
allklasse	intuitionistic	influido
kürzer	lotfi	presenten
vereinigungsmenge	antinomies	indemostrables
weshalb	topos	apela
oliver	excitement	axiomáticas
anfangsbuchstabe	schemas	diciembre
entscheidbar	discussions	escogidos
Taylor-Formel	Taylor's theorem	Teorema de Taylor
induktionsschritt	adjoining	usamos
multinomialkoeffizient	maximizing	vemos
geodätischer	compactified	enunciamos
annäherung	numerics	correcta
näherungsfunktion	dwarfed	probarse
viertes	try	α
nützlichkeit	positively	intuitive
tangens	vanishes	flechas
kapitel	centers	continuamente
karlsruhe	disks	repetida
letzte	dominated	acotar
schlömilchsche	minimizing	definámosla
kosinusfunktion	parametrizes	demuestran
ausgleichung	things	refinación
drittes	ξ	expresadas
geringen	morris	physical
kleinwinkelnäherung	refinements	resumen
eindimensionale	tell	recordemos
bessere	justified	desea
sinus	universally	mencionan
grundkurs	covers	maximizando
nähe	reliable	vélez
glied	select	cota
taylorpolynoms	wanted	classical
qualitative	courses	enunciación
passenden	holistic	hallada
schmiegparabel	demonstrative	acotaciones
skalarwertigen	reads	denominadas
kompakter	matching	ahí
abgebrochene	vanish	permanece
Mittelwertsatz der Differentialrechnung	Mean value theorem	Teorema del valor medio
besagt	joining	especifíca
zahlreicher	rolle	descrito
kurvenpunkt	pick	afectados
verschärfungen	parameshvara	rolle
konsequenz	hypotheses	paramésuara
zwischenstelle	mvt	marin
identischer	trick	sumatoria
monotonieverhalten	fix	quería
pool	ends	escoger
hilfsfunktion	monotonic	convexo
hilfsfunktionen	probabilistic	comentarios
monotoniekriterium	khan	paraleas
bruchform	cancelling	valore
konstanz	commentaries	verificado
verbindungsstrecke	classic	declarado
keinesfalls	reflex	govindasvāmi
steigend	monotonically	michel
kommenden	achieves	procederemos
kurvendiskussion	govindasvāmi	demostrada
hinreichendes	illustrates	une
veränderten	lang	ende
ausdehnung	chord	aloja
komponentenfunktionen	likely	jacobiano
übersichtsdiagramm	discards	astronomía
passende	parametrization	kerala
schrankensatz	claim	restringida
gedeutet	mean	llega
mittelwertsatz	rudin	estricto
strecke	φ	demostrado
mittelwertsatzes	false	análogo
Stetigkeit	Continuous function	Función continua
oftmals	lim	ejecuta
ausgedehnt	coarser	rampa
naheliegende	nets	denomiada
approximationssatz	pullquote	efectivamente
bildraum	indicator	producen
arbeitszeit	orderings	difieren
bieten	accomplished	centrado
komplexwertiger	growing	consultar
brouwerschen	unions	indispensable
konstruktives	gustav	dibujarse
untersuchende	nonequivalent	munkres
interessiert	finest	browniano
zugespielt	page	wilmington
homöomorphie	addressed	clásicos
morphismen	child	llegando
belieben	goursat	distribuciones
wurzelfunktion	isolated	γ
springt	preservation	observemos
herum	preimages	ciclos
c	sudden	trazo
konvergentes	unify	implicaría
aufgewandten	formalise	continudad
gerichteten	admissible	concluye
gedämpft	heaviside	trivialmente
antwort	preservations	salto
einheitswürfel	sup	contraejemplo
angenehmer	édouard	compuesta
verdoppelung	commutes	requisito
modellräume	weakened	incorporar
rollt	conversely	heaviside
Potenz (Mathematik)	Exponentiation	Potenciación
korrektheit	indirection	varía
lehrers	speak	knuth
undefiniert	vertex	sustracción
gesetze	exponentiated	permanecer
wurzelexponenten	prefer	específicas
knuth	preferring	apoyó
periodisch	posix	asignado
id	lua	álgebras
potenzturm	muhammad	consistente
zweckmäßig	korn	distribuir
grunde	accumulation	conclusión
wahlen	kilometre	multiplican
potenzoperators	metres	incidente
verdeutlicht	whatever	joaquín
monoide	xor	erróneamente
exponentenschreibweise	automorphism	sitúa
grundzahl	zenzizenzizenzic	detalles
potenzgesetze	abū	dividendo
schlussfolgerung	losing	prohibida
zweierpotenzen	haskell	desplazar
exponentiation	alternates	pertenecer
urmenge	commodore	cuadrante
rasante	enforcing	debería
effizientes	superscript	calmó
asp	jeake	enciclopedia
verteidigung	circumstances	firmó
erfinder	conjugation	quieran
anscheinend	csc	moivre
überraschend	sector	días
verachtfachung	circular	totalmente
Logarithmus	Logarithm	Logaritmo
vorkommastellen	parabola	identidades
ziffern	labour	obtenidas
nachkommastellen	believed	apoyo
müsste	precalculated	informática
zusatzbedingung	sound	primo
logarithmischen	raising	repetido
rechenschieber	logistic	texts
kanons	demand	rápidamente
widerstand	secure	francisco
erweisen	likelihoods	logarítmica
schränkt	descriptions	encuentre
unterer	circumvented	hiperbólico
empfindlichkeit	neutral	rito
skizze	keys	reflexión
hexadezimalsystem	compresses	escogido
didaktischen	napier	concuerda
graphischen	chaoticity	sonido
empirischen	ion	l
elliptischen	nernst	decrecimiento
vorangestelltes	sierpinski	impecable
zunutze	doubles	escogió
uhrmacher	acidity	napier
information	reasons	cuadratura
reellem	sorting	rápido
mögliche	propounded	ln
tonhöhe	organism	sismológica
festgelegte	farther	funcionaban
einfachlogarithmisches	artifice	dispositivos
festgelegten	widespread	recursivamente
schottische	predicts	originales
Polynom	Polynomial	Polinomio
leitkoeffizient	factorization	marcó
schranke	irreducible	simplificando
kreisscheibe	interested	divisible
koeffizientenringes	henrik	substituyendo
monomordnung	colourings	sacará
dividiert	subring	abel
polynomgleichung	sheaf	pide
zweigliedrige	golden	monomios
veranschaulichen	supposes	spline
ganzzahlig	irreducibility	investigadores
falsi	parabolic	henrik
όνομα	factorized	factoriza
schranken	joins	cuarto
pendant	circa	considere
bisschen	univariate	escriba
mehrgliedrige	solvable	νόμος
natürlichzahligen	wherein	latín
πολύ	sure	splines
reziprokes	sold	charles
kompliziertere	niels	moscú
nullstellenbestimmung	abel	incluido
zeitachse	bad	adquirir
ἐκ	diophantine	niccolò
ὀνομάτων	counted	cromático
spezialfällen	bivariate	multiplícalo
anzuordnen	unital	mónico
positivem	whetstone	fontana
monomen	factoring	πολυς
regula	exceed	ordinarios
freies	crop	remplazados
Taylorreihe	Taylor series	Serie de Taylor
wertet	recasting	irracionales
taylorreihen	bernoulli	revisited
stützstellen	apparently	trigonométrico
funktionsauswertung	philosophical	siquiera
faktorielle	subdivisions	parámetro
polynominterpolation	incurred	number
exponentialreihe	hopes	podían
restgliedformeln	break	enteras
guten	einar	choose
übereinstimmung	pink	convergiendo
fakultät	irene	trabajó
multinomialtheorem	presocratic	aristóteles
identitätsoperator	ninth	retomaron
äquidistanten	generalizing	filósofo
festes	clenshaw	hui
geeigneter	aristotle	eleata
richtungsableitung	unsolvable	considerarlo
ableitungsoperator	atomist	visualisation
entwicklungspunktes	rejected	acotando
laurentreihe	professor	trigonometric
diskretes	expectation	demócrito
konvergenzradius	writings	subdivisiones
angewandtes	visualisation	sugieren
visualisierung	scottish	zenón
nichtanalytischer	maclaurin	deshacer
konvergent	colin	methods
differenzenoperator	philosopher	can
polynomdarstellung	distant	obvia
ausnahmslos	unresolved	where
taylorentwicklung	expansions	compleja
Explizites Euler-Verfahren	Euler method	Método de Euler
simple	ode	partimos
steife	truncation	cosas
mittelpunktsregel	multistep	aproxime
wendet	midpoint	cruzan
verfahrens	backward	minimizar
anfangswertproblem	stability	diverge
eindeutigkeitsresultate	limitation	editorial
intervallgrenze	modification	evaluará
zeitpunkte	diverge	denotará
berechne	figuring	limitar
berechneten	machine	cometido
rechenarbeit	decays	derivado
quadraturformel	katherine	tomarnos
anfangswertprobleme	resorts	vienen
boxregel	astronaut	nombrado
effizientere	organize	localícese
mehrschrittverfahren	unstable	básicamente
equations	integrates	quedaría
einschrittverfahren	committed	propaga
abschätzt	slow	online
approximierten	repetitive	poligonal
schrittweite	qualitatively	truncamiento
approximationen	descent	trabajamos
umgeformt	analyze	comete
kleinerer	rosetta	regularmente
herleitung	calculi	previos
bezieht	polygonal	antonio
sinnvolle	decay	esquema
stabilitätsfunktion	auxiliary	harán
kreises	modifications	producidas
Vektor	Euclidean vector	Vector
zeitgleich	ebb	impresos
drehvektoren	wheel	implicadas
william	dealt	dibujado
transformationsverhalten	negation	dato
vektorbegriffs	transforming	contraposición
transformieren	broken	obtendríamos
parallelogramms	supplies	tensoriales
elektromagnetismus	tensors	rectitud
ändern	flights	magnético
feldlinie	graphical	concurrentes
magnetischen	c	coriolis
gerechnet	adheres	conexo
repräsentieren	n	puedan
eingeschlossene	undergoes	covariante
roland	rightward	representarán
viererimpuls	guthrie	encadenados
buchstabe	deyan	confusión
veranschaulichung	driving	hará
englischsprachigen	quadrilateral	hodge
impulskoordinaten	draw	partícula
relativistischen	centre	paralelas
koordinatensystemen	fraktur	llamar
achse	inherent	gráficamente
ignatowsky	hat	indican
kollinearer	antiparallel	fija
aktuelle	skeptical	mejores
kräfteparallelogramm	mirror	facilitarlas
teile	exposed	referirnos
konstanter	kiyosi	transformarse
pfeils	indicating	uniendo
Vektorraum	Vector space	Espacio vectorial
anschaulicher	dale	independencia
garantieren	imposed	reconsideraron
schiefkörpern	ignoring	débil
verschiebungen	homological	ausdehnungslehre
kompatibel	insofar	notaremos
sinnen	inequivalent	giuseppe
sichergestellt	leur	peano
skelett	furnish	abstraits
vieler	datum	treatment
definiter	argand	elementargeometrie
hermitescher	departing	ofrecen
strukturellen	octonions	logica
schiefkörper	span	parcialmente
weitreichende	coset	detallar
neutralität	compared	franceses
konsequenzen	ensembles	der
kleinste	guided	conserva
axiom	optimally	supiésemos
gesagte	waves	graphical
vektorraumelement	hairy	hülfsmittel
unterraums	parametrizing	et
spezifikation	elementargeometrie	cuaterniones
oberkörper	indirectly	condujeron
übertragbar	irish	some
abelsche	kernels	generado
untersuchungsgegenstand	nostrand	inventó
polynomräume	firmin	ensembles
halbkörper	barycentrische	escapan
neutralen	équations	lineale
beobachtung	atoms	linear
Skalar (Mathematik)	Scalar (mathematics)	Escalar (matemática)
tensor	vocentur	sirven
angabe	genere	excluye
ähnlichen	analyticem	escala
gegebenenfalls	artem	producir
ebenenspiegelung	vel	formalizar
abgrenzung	adjectival	isomorfo
richtungsunabhängig	restricts	adicional
transformationsgruppe	surd	soportan
modulelementes	genus	extracción
grundringes	citation	use
zahlenwertes	proportionally	describrse
grundkörpers	shall	dotarse
entfernung	ascend	q
resultierende	proportionaliter	v
diagonale	descend	k
drehungen	adscendunt	interpreta
ändert	derives	cuerpos
energie	quae	bruce
skalar	ex	describir
grundkörper	vi	físico
teilweise	sua	cuál
masse	recorded	dé
allein	usage	incluyendo
teilchen	keeping	consigo
festen	english	introducir
teilchens	module	característica
teubner	support	hermítica
charakterisiert	françois	interno
physikalische	referring	fenómeno
vektorraumes	comes	normado
Norm (Mathematik)	Norm (mathematics)	Norma vectorial
versehenen	clicks	corto
berücksichtigung	seminorms	consideración
grundring	codepoint	longitudes
gewichtetes	centrally	operacionales
kugelbegriff	localized	academic
stadtplan	taxi	notes
vektorprodukt	scalability	pese
assoziative	involution	basándonos
betragsweise	macros	explicada
minkowski	jointly	identificable
abfallverhalten	quotation	determine
versehener	supply	apunta
maximumsnorm	sublinear	simbolismo
nullfolgen	homogeneity	actúe
dissertation	taxicab	eduard
stetigkeitsmoduls	truly	sii
sublineare	seminorm	distributions
punktsymmetrisch	purposes	topological
summennorm	drive	fijada
subhomogenität	additivity	delimitan
extremwertsatz	unicode	sinónimo
senkrechte	objective	posibilidades
würfels	ǁ	astrofísica
parallelogrammgleichung	superellipse	recuérdese
könig	lecture	orientados
diagonal	seminormed	pudiéramos
subadditivität	hamming	mechanics
produktraum	contrary	fructíferas
normkugel	inversion	extraer
halbnormen	echoing	definimos
Euklidischer Raum	Euclidean space	Espacio euclídeo
überlagerung	detached	donaldson
umgebende	lesser	exóticos
flache	shifting	aprovecharse
invarianz	tenets	simon
identifizierung	equilateral	finitodimensionales
axiomatisch	isometries	homeomorfa
rechnerisch	bear	resaltar
raumkonzepte	drawings	lie
ausnahmen	obvious	considerados
isometrisch	stabilizers	prototípico
affiner	galilean	homeomorfo
cole	stabilizer	euclides
homöomorphe	preferable	dotar
bestehenden	screw	poseer
anschauungsraum	similarities	infinitodimensional
ineinander	additionally	concebir
bezugspunkt	translationally	inducido
handeln	incidence	servido
nachdem	diffeomorphism	fibrado
hochgestellte	experienced	invariancia
postulate	velocities	versiones
bewegungen	ignore	difeomorfa
anschauungsraums	prescribes	euclidianos
raumbegriffe	deforming	copias
standardbasisvektors	transitively	topológica
teilkörpern	spacetime	proyectar
torus	inches	tuplas
punkträumen	hypersurfaces	pitágoras
transitiv	polyhedra	métrica
hilbert	invariance	euclídeo
Matrix (Mathematik)	Matrix (mathematics)	Matriz (matemáticas)
sylvester	companion	fundando
fettgedruckte	theoretically	iba
matrixmultiplikation	indexing	fuentes
runde	dynamics	traslación
quadratischer	eisenstein	indexada
teilklasse	equates	inmediatamente
minor	halle	alto
projektionsmatrizen	camera	mapa
kompakteren	reinterpret	trabajaron
matrixelemente	utilize	mismas
nebenstehender	gordon	etiquetado
spaltensummen	refraction	ii
sesquilinearformen	coupled	invertibles
schlüsselkonzept	reprint	dejar
unveränderliche	hildbert	conectados
antiselbstadjungierten	diagonalizing	abuso
matrixprodukts	r	mil
beteiligten	electronics	fk
definit	star	minúscula
klammerung	roads	latinos
erleichtern	adjacency	búsqueda
matrixproduktes	recursive	conmutativa
büchern	engendered	incidencia
endomorphismen	gary	motivación
endlichem	leonard	tipográfica
kette	subscripted	escogiendo
matrixelement	possibilities	articulaciones
schiefsymmetrisch	websites	impuestas
idempotente	proposition	podremos
symmetrischer	vaidyanathan	heisenberg
Skalarprodukt	Dot product	Producto escalar
abstrakte	presentations	bilineal
modifiziert	contraction	devuelve
versionen	cancellation	estudiados
dazugehörige	dyadics	generalizando
gleichorientiert	dyadic	retorna
hubarbeit	demonstrations	geodésica
bevorzugt	emphasizes	secuencias
axiomensysteme	remembered	cortas
gymnasiale	blas	interiores
jakob	salvaged	oportunidad
winkeln	kahan	profesores
auswirkungen	nevertheless	conjugada
ermöglichen	θ	jorge
entgegengesetzt	sesquilinear	prehilbert
positivdefinitheit	dot	adopta
überstrich	suffer	proy
quadrieren	obey	generadas
alternativversion	ℕ	enseñanza
schiefe	previously	rectificable
semilinearität	cost	cos
motivierten	keeping	amplía
lotfußpunkt	dotted	modifica
skalars	fulfills	realizaría
beispiels	distributivity	recto
assoziativität	bruce	θ
gewonnenen	designate	existente
eingezeichneten	summarized	ligeramente
skalarproduktes	catastrophic	sesquilineal
daraufhin	magnitudes	reciben
innenproduktraum	formulations	induce
Lineare Gleichung	Linear equation	Ecuación de primer grado
homogenen	crosses	plantea
lösungsraum	fewer	coincidente
kennzeichnend	obviously	abcisas
quadriert	regrouping	complicado
startwerten	violate	segmentaria
diophantischen	converted	despejando
typen	subareas	intersecciones
elliptische	parameters	afirmarse
kokern	extent	verdadera
differentialoperator	intercept	asunto
differenzengleichung	belief	simultáneamente
vorfaktor	passes	hiperplano
differenzengleichungen	searches	existirán
charakteristiken	leaving	dejando
parametrisierungen	modeling	interceptando
geteilt	tax	involucra
randbedingungen	unknowns	corta
integraloperator	sciences	admiten
bernd	social	manipulación
inhomogenen	proportionality	original
operatorgleichungen	providing	planos
vektorgleichung	rewrite	incógnita
superpositionseigenschaft	progressive	interpretaciones
wählbar	everyday	cumplirse
jürgen	designate	horizontal
annehmen	understand	convertirse
äquivalenzumformungen	subscripts	reescribirse
parallele	constants	trivial
rechter	helpful	conmutativo
koordinatenform	parameter	independientes
Einheitsmatrix	Identity matrix	Matriz identidad
zeilentausch	trivially	inmersa
softwarepaket	immaterial	matrix
moduls	ambiguously	concisamente
mathematica	infinitude	describir
einheitsmatrizen	concisely	trivial
siegfried	german	considerada
matlab	books	delta
definierenden	regardless	identidad
abbildungsmatrizen	delta	deducir
spaltenvertauschungen	idempotent	permutación
vollem	boldface	dependiendo
vielfachheit	kronecker	infinitas
matrixexponential	zeros	diagonal
nullte	serves	neutro
zentrische	identity	unitario
zentrum	trace	aún
identitätsabbildung	full	va
außerdiagonalelemente	identical	simplemente
nullelement	otherwise	quiere
untergruppen	ones	tamaño
einsen	size	escribir
einheitsmatrix	main	dimensiones
ursprungsebene	diagonal	veces
darstellungsmatrix	square	existen
nullen	linearly	escribe
einselement	transformations	finita
maximalen	represent	toda
streckungsfaktor	root	dimensión
spiegelung	invertible	ningún
charakteristischen	property	aplicación
Orthogonale Matrix	Orthogonal matrix	Matriz ortogonal
faktorisiert	mehrdad	madrid
standardskalarprodukts	magnifying	tema
permutationsmatrix	negates	profundizar
blockdiagonalmatrix	extracting	extensivamente
hackbusch	loan	isométricas
unterbestimmter	givens	isomorfismos
gehöriger	exploration	pude
semidefiniten	pivoting	subgrupo
verschiebungseigenschaft	overdetermined	fibrados
trifft	procrustes	verificar
übrigen	averaging	especulares
eigenwerten	confirms	rígidos
diagonaleinträge	economical	transpuesta
volker	across	internos
eigenwertprobleme	demands	inversiones
unimodulare	vacated	transformaciones
spektralsatz	minimizes	ortogonal
datensätze	fixing	recíproco
drehung	iterations	reflexiones
eigenräume	semidirect	singular
statistik	advantageous	teorías
polarisationsformel	bring	ortogonales
dient	diagonalizes	llamadas
drehmatrix	modulus	ortonormal
anwendungsfeld	babylonian	computación
polarzerlegung	twists	caracterización
drehmatrizen	floating	inmediato
uneigentlich	accelerated	cuadrados
winkeltreuen	tempting	usadas
überbestimmter	squared	satisfacen
Orthogonalität	Orthogonality	Ortogonalidad (matemáticas)
zeichenkodierungsstandard	tv	griego
orthogonalitätsrelationen	investigation	cilíndricas
statistischen	algol	familia
orthogonalverfahren	propagates	tensiones
elementargeometrie	interfere	isostáticas
html	cartridge	productor
unicode	subcarriers	convencional
vermessung	cytosine	envolventes
enthaltenen	azide	suaves
inzidenzebenen	analyses	interesantes
orthogonalitätsbegriff	classifications	tracción
orthonormalen	mondrian	esféricas
normalenvektor	oeuvre	perpendicualares
umstand	stereo	califica
skalarproduktraum	rewriting	familias
systems	cyclooctyne	ortogonalidad
komplements	vinyl	notado
projektionssatz	deprotection	ortogonales
skalarproduktraums	feasible	euclídeas
unverändert	receiver	complemento
interessante	observables	geométricos
polygon	reversibly	curvas
benachbarte	groove	cualesquiera
windschief	redundant	compresión
polyeder	testing	tangentes
schroedel	register	resultan
schwächer	nonoverlapping	m
parallelität	eliminated	coordenadas
schnittpunkt	synthetic	tensor
skalarprodukträume	museum	dirá
Einheitsvektor	Unit vector	Vector unitario
orthogonalisierungsverfahren	counterclockwise	acento
bevorzugte	minimize	coordenados
hesseschen	triplet	ortogonalización
zulassung	handbook	normalizar
hut	roles	afirmado
häufigsten	arfken	versor
vr	themes	asociado
einheitsvektoren	versors	cartesianos
kanonischen	amounting	versores
angewandten	resolve	frecuencia
gewöhnlich	azimuthal	referirse
gelingt	corrects	breve
kanonische	radial	transforma
gekennzeichnet	versor	analíticamente
unendlicher	subtended	frecuente
naturwissenschaften	normalized	comienzo
normiert	contexts	circunflejo
hilberträumen	cylindrical	designan
winkels	spherical	asociados
aufeinander	spatial	conveniente
michiel	identify	unitario
rechnungen	freedom	determinada
hazewinkel	weber	transformar
einheitsvektor	synonym	razón
notwendig	designated	proyección
vektorraumes	operated	tendencia
spielt	murray	evidente
kosinus	symmetry	simplemente
kartesisches	rotating	dirección
stehen	delta	frecuentemente
Determinante	Determinant	Determinante (matemática)
schematische	mahajan	mal
multilinearen	jacobians	puras
charakteristisches	treating	impuso
totales	manin	correctas
gauß	improvement	conocimientos
systematisierte	announced	redescubiertos
schnittpunkten	improved	empleado
bezeichne	clockwise	triangularización
anknüpft	invertibility	representaba
laplacesche	cholesky	aumenta
unabhängigen	st	permutaciones
sarrus	spanning	cuádrica
permutationen	unfortunately	síntesis
streichen	day	déterminante
cramerschen	counterparts	computacional
befassten	morphism	contribuyeron
nützliches	pattern	demostraciones
näherungsformel	semidefinite	creado
komplemente	multidimensional	trataremos
ternären	inefficient	cara
späteren	combinatorial	interesó
dreiecksmatrizen	mnemonic	heinrich
kästchensatz	interchange	reflejado
gabriel	discriminant	páginas
verschiedenes	sarrus	paralelamente
gleichungssystemen	suffixes	eliminando
vorgegebene	bars	manuscrito
alternierend	imagining	determinates
studien	walks	morfismo
multilinearform	fashion	ofreció
